=== ИЗ СЦЕНАРИЕВ (03–07) ===

Te quiero — Я тебя люблю
Te amo — Я тебя люблю (сильнее)
Eres el amor de mi vida — Ты любовь всей моей жизни
Me vuelves loco — Ты сводишь меня с ума (м.)
Me vuelves loca — Ты сводишь меня с ума (ж.)
El Día de San Valentín — День святого Валентина

Gracias por estar siempre — Спасибо, что ты всегда рядом
Te aprecio mucho — Я тебя очень ценю
Eres importante para mí — Ты важна/важен для меня
San Valentín — День святого Валентина

Eres preciosa — Ты прекрасна
Eres precioso — Ты прекрасен
No puedo vivir sin ti — Не могу без тебя жить
Mi media naranja — Моя половинка
Tienes los ojos más bonitos — У тебя самые красивые глаза

cariño — дорогой, милый
amor — любовь (обращение)
cielo — небо (ласково)
mi vida — моя жизнь
bombón — конфетка
corazón — сердечко
mi rey — мой король
mi reina — моя королева

Contigo soy feliz — С тобой я счастлив/счастлива
Eres increíble — Ты невероятный/невероятная
Me haces muy feliz — Ты делаешь меня счастливым/счастливой


=== ДОПОЛНИТЕЛЬНО ПРО ЛЮБОВЬ ===

Te echo de menos — Я скучаю по тебе
Te extraño — Я скучаю по тебе (часто в Лат. Америке)
Estoy enamorado / enamorada de ti — Я влюблён/влюблена в тебя
Me gustas mucho — Ты мне очень нравишься
Me encantas — Ты меня очаровываешь
Eres muy especial — Ты очень особенный/особенная
Eres único / única — Ты единственный/единственная
Para siempre — Навсегда
Juntos para siempre — Вместе навсегда
Eres mi todo — Ты моё всё
Sin ti no soy nada — Без тебя я ничто
Tú eres la razón — Ты причина (моей радости и т.д.)
Feliz Día de San Valentín — Счастливого Дня святого Валентина
Feliz día de los enamorados — Счастливого дня влюблённых
Te quiero con todo mi corazón — Люблю тебя всем сердцем
Eres la persona más importante — Ты самый важный человек
Gracias por existir — Спасибо, что ты есть
Qué suerte tengo de tenerte — Какое счастье, что ты у меня есть
Mi amor — моя любовь
Mi cielo — моё небо
Mi corazón — моё сердечко
Guapo — красавчик
Guapa — красавица
Hermoso / hermosa — прекрасный/прекрасная
Precioso / preciosa — прелестный/прелестная
